wwwwwwwwwwwwwwwwwwwwwww
w-----e-------------e-w
w*****--***-----------w
w---e---www-e--***----w
w---e-*******-ee----www
w--wwwwwww----wwwww---w
w---p-----------ee----w
w------e-------wwww---w
w---------------------w
wwwwwwwwwwwww****---**w
w----------www--------w
w-eee-******-------wwww
w--&---------e--------w
wwwwwwwwwwwwwwwwwwwwwww
