wwwwwwwwwwwwwwwwwwwwwww
w----e------------&---w
www----wwwwwwwwww-----w
w---*----------e---**-w
w---------------------w
w--------*----------www
w--e------------------w
wwww*******-----------w
w----------------**---w
w----------------e----w
w---****wwwwwwwww-----w
w---------------------w
w--p---*--------------w
wwwwwwwwwwwwwwwwwwwwwww
