wwwwwwwwwwwwwwwwwwwwwww
w-----p---------------w
w---------------------w
w---*-------e---------w
w---------------------w
w--------*----------www
w---wwwwwww-----------w
w----------wwww---**--w
w---------------------w
w---------------------w
w--*****------wwwwww--w
w---------------------w
w--------**----e----&-w
wwwwwwwwwwwwwwwwwwwwwww

