wwwwwwwwwwwwwwwwwwwwwww
w----p----------e-----w
w***---***------------w
w---*------*******---*w
w---wwwwwwwww---------w
w--------*----------eew
w----------*******----w
w------e--------------w
w---wwwww***----**---w
w---ee-e----------e---w
w-----------wwwww-----w
w----******-------www-w
w------------e----&---w
wwwwwwwwwwwwwwwwwwwwwww
