wwwwwwwwwwwwwwwwwwwwwww
w----e--------e--e----w
wwwwwwwwww----wwwe--www
w-------------w***---*w
w---e-*******-we---&--w
w--wwwwwww----wwwwwwwww
w---------------------w
w------e-------wwww---w
w---wwwww***----**----w
w-----e-----------e---w
w-**------------------w
w----******-------www-w
w--p---------e--------w
wwwwwwwwwwwwwwwwwwwwwww
