wwwwwwwwwwwwwwwwwwwwwww
w-------------------p-w
w*****--***---*****-www
w---e---www-e--***----w
w---e-*******-ee----www
w--wwwwwww----wwwww---w
w---ee---------ee----w
w------e-------wwww---w
w---********----******w
w-----------*****e----w
w***------------------w
w-eee-******-------wwww
w--&---------e--------w
wwwwwwwwwwwwwwwwwwwwwww
